#####
# o #
# @ #
# o #
# . #
#####